NO ./xpm/blue.xpm42
SO ./xpm/red.xpm42
WE ./xpm/green.xpm42
EA ./xpm/yellow.xpm42

F 255,255,255
C 225,30,0

        1111111111111111111111111
        10000000001100 0000000001
      111011000001110000000000001
        10010000000000 0000000001
111111111011000001110000000000001
100000000011000001110111111111111
11110111111111011100000010001
11110111111111011101010010001
11000000110101011100000010001
10000000000000001100000010001
10000000000000001101010010001
11000001110101011111011110N0111
11110111 1110101 101111010001
11111111 1111111 111111111111